###########
#       # #
# ### # # #
#   # #S  #
##### #####
#     #E  #
# ### ### #
# #     # #
# ####### #
#         #
###########