###################################################
#           #         #   #               #     # #
# ####### ### ### ### # # # ##### ####### # ### # #
# #   # #   #   # # # # #       #     # # # #   # #
# # # # ### # ### # # ############### # # # # ### #
#   # #   #   #   # # #   #           #   # #     #
##### # ####### ### # # # # ########### ### ##### #
#   # #       # #   #   # #   #       #   # # #   #
# ### ### # ### # ####### # # ### ### ### # # # ###
#         # #   # #     # # #   #   #   #   # # # #
# ########### ### # ### # # ### ####### ##### # # #
#   # #       #   # # # # # #   #   #   #     #   #
### # # ####### # # # # # ### ### # # # ##### ### #
# #   # #       # # # # # #   #   #   #   #   #   #
# # ### ####### ### # # # # ### ######### # # # ###
# # #   #     #       #     #   #   #   #   # # # #
# # # ### ### ############### ### # # # ##### # # #
#   #   #   #           # #     # #   #   #   # # #
####### ### ########### # # ### ##### # ### ### # #
#     # #   #           #   #   #   # #       #   #
# ### # # ### ########### ### # # # ##### ####### #
#   # # #   #   #   #       # # # #     # #       #
### # # ### ### # ### ####### # # ##### ### #######
#   #     #   # #     # #   # # #     #     #     #
# ####### ### # # ##### # # # ####### ########### #
# #       #   # #       # # #       #     #       #
# # ####### ### ####### # ### # ######### # ##### #
# #     #   # # #       # # # # #       #   # #   #
# ####### ### # # ####### # # # # ##### ##### # ###
#   #     #   # #       # #   #   #   #       # # #
### # ##### ### # ####### ##### ### # ##### ### # #
#   #   #   #   # #       #   #   # # #   # #   # #
# ##### ### # ### # ####### # ### # # # ### # ### #
# #   #   # # #   #         #   # # #   #   #     #
# # # ### # # ################# # # ### # # ##### #
# # #   # # #               # # # #   # # #     # #
# # ### # # ############# # # # # ### ### ####### #
#     #   #   #   #     # #   # #   S #   #       #
######### # # # ### ### # ##### ##### # # # #######
#   #   #   #   #   # #   #     #   # # # #     # #
# # # # ####### # ### ### # ##### # # # ####### # #
# #   #       # # #       # #     #   #       # # #
# # ######### # # ### ##### ####### ######### # # #
# # #   #   # # #   # #   # #     #   #     #   # #
# # # # # # # ##### # ### # # ### ### ### # ##### #
# # # # # # # #   # # #   #   # #   #     # #     #
# ### # # # # # # # # # # ##### ### ####### ##### #
# #   #   # #   #   #   #     #   # # #     #     #
# # ####### ################### # # # # ##### ### #
#        E#                     #   #         #   #
###################################################