   #    S      #   
## ####### ### # # 
   #     #   #   # 
 ### ### ######### 
     # #           
###### ########### 
       #       #   
 ##### # ### ### ##
 #   #   # # #   # 
 # # ##### # # ### 
 # #       #   #   
 ##### ### ####### 
     # # #         
#### # # # ####### 
 #   #   #       # 
 # ########### # ##
 # #     #   # #   
 # # ### # # ##### 
E    #     #       