###############################################
# #   #   #   #               # #           # #
# # # # ### # # # ########### # # ##### ### # #
#   # #     #   #   #   #     #     #   #   # #
##### ############# # # # ########### ### ### #
#   #             #   # #   #   #   #   #     #
# ############### ##### ### # # # # ### ##### #
#   #     #     #       # #   #   #   # #   # #
### # ### # # # ######### ########### # # # ###
#   #   #   # #   #             #     #   #   #
# ##### ##### # ### ### ####### # ########### #
#       #   # # #     # #     # #   #         #
# ####### # # ### ##### # ### # ### ### ##### #
#   #   # #E# #   # #   # #   # # #S#   #   # #
##### # # # # # ### # ### # ### # # # ### # # #
#     #   #   # #   # #   #       #   # # #   #
# ######### ### ### # # ####### ####### # #####
#   #   #   #   #   # #   #   # #     #   #   #
# # ### # ### ### ### ### # # ### # # # ### # #
# #   # # # # #   #   # # # #     # # #   # # #
# ### # # # # ### # ### # # ####### ##### ### #
# # # #     #   # # #   # # #     # #   #   # #
# # # ### ##### # # # # # # # ##### # # ### # #
# # #   # #   # # # # #   #   #     # #   #   #
# # ### ### # # # # ######### # ##### # ##### #
#     #     #     #           #       #       #
###############################################