 # # # # # # # # # 
#### # # # ##### ##
   # # # #   #   # 
## # # ############
 # # # #   #   #   
## ##### ##### ####
   # #   #   # # # 
###### ##### # ####
 # # # #   # # #   
#### ##### # ######
   # # # # # # #   
## ##### ### ######
 #   # #   # # # # 
###### ### ##### ##
   # # # #   # #   
#### ### ##### ####
 # # # # # #   #   
## # # # ### ######
 # # # # # # # # # 