#          S
# ######### 
# #       # 
# # ##### # 
#   #     # 
### # ##### 
E   #       